
NO ./text/purplestone.xpm

R      1080         840
WE ./text/greystone.xpm
SO    ./text/bluestone.xpm


   EA ./text/redbrick.xpm            
  C  139      , 69, 190
S ./text/coin1.xpm
F 75, 0 385, 130

        111111111111111111111111
        1000000000110000002000001
        1011000001110022220000001
        1001000000000222200022221
111111111011000001110000000000001
100000000011000001110111110111111
11110111111111011100000010001
11110111111111011101010010N00
11000000110101011100000010001
10002000000000000000000010001
10000000000000001101010010201
1100000111010101111101101000111
11110111 1110101 101111000001
11111111 1111111 11111111111